  #####
#     #
#     #
#     #
#D###Z#